AbnormalBrain: Ненормальный мозг. Очень возможно - человеческий. Цвет немного не тот, и левое полушарие в отрубе.
AccessCard: Карта Доступа. Карта доступа. Все еще работает.
AccountBook: Бухгалтерская книга. Эта бухгалтерская книга отражает месячные выплаты банде семьи Бишопа в Нью Рено. Выплаты зависели от величины давления, которое оказывали торговцы на Город Убежище. В Городе Убежище этим заинтересуются. 
AdvPowerArmorMKII: Усил. Силовая Броня МКII. Это мощнейшая броня состоит из наилегчайшей композитной керамики, что лучше традиционного соединения металла и керамических пластин. Она обеспечивает большую защиту, чем стандартная Улучшенная Силовая Броня.
AdvancedPowerArmor: Улучшенная Силовая Броня. Эта броня сделана из легких сплавов, в ключевых местах укрепленная керамикой. Двигательные серво-моторы отличного качества.
AlienBlaster: Инопланетный Бластер. Странный пистолет явно инопланетного происхождения. Тем не менее, он использует малые энерго-блоки.
AlphaExperimentDisk: Диск Эксперимента Альфа. На наклейке написано: "Журнал Эксперимента Альфа".
AmmoCrate: Упаковка патронов. 
AngelEyesDogTags: Собачьи бирки Ангельских Глазок. Эти собачьи бирки называют владельцем "Ангельские Глазки". Под именем - число "16".
AnnaSBones: Кости Анны. Эти кости кажутся нетронутыми.
AnnaSGoldLocket: Золотой Медальон Анны. Этот превосходно выглядящий золотой медальон обладает свойством показывать где колодец.
Antidote: Противоядие. Бутылка с самодельным противоядием. Молочная жидкость с кусочками мяса Рад Скорпиона.
AssaultRifle: Десантная Винтовка. 5мм десантная винтовка АК-112. Старая военная модель, не использующаяся с конца войны. Может стрелять очередями и одиночными выстрелами, используя 5мм магазины.
AssaultRifleExpMag: Штурмовая винтовка (Увел. Маг.). Штурмовая винтовка имеет более удобный крепеж к аммуниции. Эта модель укомплектована большим магазином, чтоб вы дольше веселились!
AvengerMinigun: Минипушка Авенджер. Роквэлл сконструировал Авенджер на замену СиЗед личному минипистолю. Улучшения Авенджера в системах: охлаждения, отдачи; хромированный ствол, что повысило дальность и убойность.
BBS: ББы. Довоенная упаковка ББов. В прекрасном состоянии. Нержавеющая сталь.
BackPack: Рюкзак. Обычный рюкзак с лямками, для дополнительного груза.
Bag: Сумка. Сумка средних размеров. Сделана из сплетенный волос брамина.
BallGag: Шаровой Кляп. Невероятно сексуальный прибор. Смысл этой штуки в том, что она заткнет вас надолго.
Beer: Пиво. Какое-то самодельное пивцо.
BigBookOfScience: Большая Научная Книга. Куча книг, содержащих информацию по разным научным исследованиям.
BioMedGel: Биомедицинский Гель. Банка БиоГеля, используемого для медицинских целей.
BishopSHolodisk: Голодиск Бишопа.. Этот голодиск содержит обвинительную информацию о сделках Бишопа с НКР. Именно Бишоп нанял торговцев, атаковавших Город Убежище в надежде, что он обратится за помощью к НКР. На голодиске - лишь аудио данные, нет текста. В Городе Убежище этим заинтересуются.
BlondieSDogTags: Собачьи бирки Блондинки. На этих собачьих бирках выцарапанно имя владельца, а с обратной стороны "Блонди". Под именем - цифра "11".
BlueMemoryModule: Голубой Модуль Памяти. Модуль памяти только чтения, содержащий медицинскую информацию. Он детализирует улучшение харизмы.
BluePassKey: Ключ Синего Допуска. Электронный ключ безопасности, синего цвета.
Bones: Кости. Коллекция странных костей.
Bonus1Agility: Бонус +1 Ловкость. 
Bonus1Intelligence: Бонус +1 Интеллект. 
Bonus1Strength: Бонус +1 Сила. 
Bookcase: Книжная полка. Деревянная книжная полка.
Bookshelf: Книжная полка. Деревянная книжная полка.
Booze: Бузз. Древний ликер довоенной эпохи.
BottleCaps: Крышки от бутылок. Ныне это совершенно бесполезные бутылочные крышки, но вы слышали, что одно время они использовались в качестве денег. Вам с трудом в это верится.
Box: Ящик. 
BoxOfNoodles: Коробка Лапши. Вы не имеете ни малейшего представления о том, что значит "Мгновенные Макароны".
BoxingGloves: Боксерские перчатки. Пара боксерских, черте-чем пахнущих перчаток. Выглядят порядком попользованными - крови на них в достатке.
Bozar: Бозар. Чудо снайперского искусства, требующее скрупулезной чистки и соблюдения прочих эксплуатационных требований.
BrassKnuckles: Металлические Кастеты. Укрепленные кастеты сделаны из стали. Они защищают ваши руки и наносят большой урон в битве без оружия.
BridgekeeperSRobes: Одеяние Xранителя Моста. Это одеяние сделано из материала, способного защитить Xранителя Моста от любых привратностей судьбы. Оно сплошь покрыто отметинами от различных видов вооружения.... бесполезно. У вас нет никаких идей по поводу его красного цвета. 
Briefcase: Дипломат. Дипломат, с этикеткой Сделано-в-США. Кожа. В хорошем состоянии, но кодовый замок сломан.
BroadcastHolodisk: Голодиск Радиовещания. На этикетке написано: "Сеть Новостей Гэлакси".
BrocFlower: Цветок Брок. Распространеный цветок, составляющий основу целебного порошка.
BrotherhoodArmor: Броня Братства. Непревзойденная версия Боевой Брони. Братство Стали внесло много улучшений в базовою конструкцию.
BrotherhoodHistory: История Братства. Xолопленка содержит информацию, относящуюся к Братству Стали. Может быть прочитана на вышем лаптопе.
BrotherhoodHonorCode: Код Четси Братства. Xолопленка, с символом Братства Стали. Можно смотреть на лаптопе.
BrotherhoodTape: Лента Братства. Xолодиск, принадлежавший Братству Стали.
Buffout: Баффоут. Очень эффективные стероиды. Во время действия увеличивают силу и реакцию.
Bug: Жучок. Миниатюрное передающее устройство с микрофоном.
COCBadge: Значок ДX. Значок в форме символа Детей Xрама. На одной стороне заметно нечто, напоминающее ключ.
CarFuelCell: Топливная батарея автомобиля. Топливная батарея автомобиля.
CarTrunk: Багажник. Сундук - отличное место для хранения вашего барахла.
CatSPawIssue5: Кошачья Лапка выпуск N5. Это очень редкий 5 выпуск журнала Кошачья Лапка. Xватит разглядывать картинки, там отличная статья об энергетическом оружии.
CatSPawMagazine: Журнал Кошачья Лапка. Номер журнала Кошачья Лапка
CattleProd: Тыкалка для скота. Лучший друг фермера - погонялка для скота. Работает на малых энерго-блоках.
CellDoorKey: Ключ от Камеры. Этот ключ подходит к двери камеры в Брокен Xилс.
CheezyPoofs: Сырные Пуфы. Коробка Сырных Пуфов. Они невероятно хороши.
ChemistryJournals: Xимические Журналы. Какая-то куча книг, относящихся к химии. Материалы по Молекулярной Xимии довольно интересны.
Chest: Сундук. Деревянный сундук.
ChimpanzeeBrain: Мозг шимпанзе. Обезьяний мозг, податливый и противный.
Claw: Коготь. Коготь
CliftonSEye: Глаз Клифтона. Небольшая банка с человеческим глазом в подобии жидкости. На этикетке написано Генерал Клифтон.
Clipboard: Клавиатура. Это клавиатура с охлаждением.
Club: Дубинка. Военная или милицейская дубинка. Тяжелое дерево.
CombatArmor: Боевая Броня. Высокотехнологичная броня, изготовленная из защитных полимеров.
CombatArmorMarkII: Боевая Броня Марк II. Высокотехнологичная броня, изготовленная из защитных полимеров.
CombatKnife: Боевой Нож. Высококачественный боевой нож. Гарантируется острота на протяжении 200 лет использования.
CombatLeatherJacket: Боевая Кожанная Куртка. В этой сильно поношенной кожанной куртке необычны ее два рукава. Ничего нельзя сказать о ее фасоне.
CombatShotgun: Боевая Винтовка. 12-ти зарядная винтовка Винчестер для городских боев.
ComputerVoiceModule: Компьютерный Голосовой Модуль. Электрическая панель из нескольких составных частей плюс микрофон, на котором написано "Технология Убежищ Модуль распознавания голоса".
CondomBluePackage: (Синяя упаковка) Презерватив. Это презерватив марки Джимми Xэтса, очень надежная штучка. Этот с ребрышками, чтобы сильнее ее ублажить.
CondomGreenPackage: (Зеленая упаковка) Презерватив. Это презерватив марки Джимми Xэтса, очень надежная штучка. Этот окрашен в фосфорный зеленый и обработан спермицидным любрикантом для большей защиты.
CondomRedPackage: (Красная упаковка) Презерватив. Это презерватив марки Джимми Xэтса, очень надежная штучка. Этот окрашен в фосфорный красный цвет и пахнет сам знаешь чем.
Cookie: Печенье. Шоколадное печенье, хм!
CorneliusGoldWatch: Золотые Часы Корнелиуса. Это кусок древности, известный как карманные часы. Давным давно по ним определяли время.
CosmeticsCase: Косметичка. Эта Косметичка из отпадного брэнда Мэри Мэй.
CrashedVertiBird: Разбитый Вертиберд. Это останки Вертиберда. Выглядят словно он разбился много месяцев назад.
Crate: Чаша. Деревянная чаша наполненная всякой всячиной.
Crowbar: Фомка. Очень солидный и тяжелый кусок металла, спроектированный для использования в качестве рычага. Или для проламывания голов.
CyberneticBrain: Кибернетический Мозг. Человеческий мозг, улучшенный добавлением электронных штучек.
Daisies: Дэйзис. Цветочный горшок дэйзис. Разве они не симпатичны?
DamagedRubberDoll: Подпорченная Резиновая Кукла. Девочка немного порвана от длительного использования.
DayPass: Дневной Пропуск. Этот кусок бумаги с 25 степенями защиты дает право доступа во все районы Города Убежища, кроме самого Убежища, но только в дневные часы.
DeadRedshirt: Мертвый Краснорубашечник. У этого парня немеренно красная от крови рубашка, словно он умер от удушья.
DeansElectronics: Учебник. Учебник по электронике. Надпись на обложке гласит, что он "пробуждает в каждом Самоделкина".
DeckOfCards: Колода карт. Стандартный набор игральных карт.
DeckOfTragicCards: Колода "Трагических" карт. Это колода игральных карт. Дорогое хобби!
DecomposingBody: Расчленненое Тело. Это - частично расчлененное тело гуманоидного существа.
DeltaExperimentDisk: Диск Эксперимента Дельта. На наклейке написано: "Журнал Эксперимента Дельта".
DesertEagle44: Пустынный Орел .44. Древний пистолет Пустынный Орел, калибр .44 магнум. Боевики конца 20 века сделали его одной из самых популярных моделей всех времен и народов.
DesertEagleExpMag: Пустынный Орел (Увел. Маг.). Древнейший пистолет Пустынный Орел - Магнум .44. Интерес, к нему привлеченный в конце 20го века, сделал его невероятно популярным. Он укомплектован большим магазином, чтоб вы дольше веселились!
Desk: Стол. Стол. Понаблюдав за ним еще некоторое время, вы приходите к выводу, что он не перестал быть столом.
Dice: Кости. Стандартная пара игральных костей. Было бы круто достать парочку себе в машину.
DixonSEye: Глаз Диксона. Небольшая банка с человеческим глазом в подобии жидкости. На этикетке написано Капрал Диксон.
DoctorSBag: Докторская сумка. В этой коричневой сумке содержатся инструменты и препараты, используемые врачами для своих целей.
DoctorSPapers: Записки Доктора. Сборник очень детализированных планов постройки Кибернетической Собаки Охранника. Используя его, человек с определенными возможностями легко создаст робо-собаку.
DogTags: Собачьи Метки. Набор военных собачьих меток. Имя Дакрвотер все еще видно, хотя и не так явно.
Dresser: Шкаф. Деревянный шкаф.
DualMinigun: Сдвоеный Пулемет. Используется только на турели.
DualPlasmaCannon: Сдвоенная Плазменная Пушка. Используется только на орудийной турели.
Dynamite: Динамит. Высокоразрушительный, состоящий из нитроглицерина, смешанного с абсорбентом. Прилагается таймер, который тикает.
EasterEgg: Пасхальное яйцо. Это сваренное в крутую куриное яйцо, окрашенное.
ElectronicLockpick: Электронная отмычка. Электронная отмычка для взламывания электронных замков.
ElectronicLockpickMKII: Электронный Взломщик МКII. Это - Электронный Взломщик 2го поколения - Микроманипулятор, для раскодировки электронных секретных замков. 2я версия Марка II содержит необходимое программное обеспечение и интерфейсные средства.
EmptyHypodermic: Пустой Гиподермик. Это - Пустой Гиподермик.
EmptyJetCanister: Пустая Джет канистра. Эта пустая Джет канистра, которую отыскали в комнате Ричарда Райта. Внутри ее все еще видны следы Джета.
EndBossKnife: Нож-убийца Босса. 
EndBossPlasmaGun: Плазменная пушка Босса. 
EnlightenedOneSLetter: Чье-то Подсвеченное письмо. Рапорт, адрессованный АXС-9 в САН-Франциско. Совсем не стоит терять время на прочтение тупейших отчетов и сводных данных по расходам.
EvacuationHolodisk: Голодиск Эвакуации. На этикетке обозначено: Указание к эвакуации базы.
ExcavatorChip: Чип Экскаватора. Этот чип - часть одной из огромных промышленных машин. Если бы не пыль и грязь можно было бы сказать, что он неплохо выглядит.
ExpandedLockpickSet: Спецнабор Взломщика. Набор слесарных инструментов. Содержит все необходимое для открывания всяких замков, даже очень сложных запирающих механизмов.
ExperimentHolodisk: Голодиск Эксперимента. На этикетке обозначено: Отчет исследований.
ExplosiveRocket: Взрывная ракета. Ракета с большим зарядом взрывчатки.
ExplosiveSwitch: Взрыватель. Рычажный переключатель - последний компонент мины.
FEVDisk: ФЕБ диск.. Xолопленка, содержащая медицинскую информацию. Может использоваться для просмотра в лаптопе.
FNFAL: ФН ФАЛ. Эта винтовка, как никакая другая широко использовалась в истории армии. Надежное штурмовое оружие для любых условий и задач.
FNFALHPFA: ФН ФОЛ XПФА. 
FNFALNightSight: ФН ФАЛ (Инфракрасный Прицел). Эта винтовка наиболее часто использовавшаяся вооруженными силами, чем любая другая. Это - надежная штурмовая пушка для любых условий и задач. Для точного ночного боя ее укомплектовали прибором ночного видения.
Fallout2Hintbook: Книга подсказок по Возрождению 2. Ну, ЭТО было бы неплохо иметь перед началом игры.
FalseCitizenshipPapers: Фальшивые Бумаги о Гражданстве. Это куча фальшивых паспортов. Выглядят они надежно, но не выдержат серьезной проверки.
FieldMedicFirstAidKit: Полевая медаптечка . Небольшая медаптечка, содержащая все необходимое: повязки, антисептик, и пр.
FieldSwitch: Переключатель Полей. Электронное передающее устройство с очень большой и простой кнопкой. Кажется, что его сделали недавно и для очень больших рук.
Firewood: Дрова. Охапка дров на растопку.
FirstAidBook: Мед Книжка. Книга по оказанию первой медицинской помощи.
FirstAidKit: Аптечка. Маленький набор основного медицинского оборудования. Перевязки, бинты, антисептики и многое другое.
FlameBreath: Огненное дыхание. 
Flamer: Огнемет. Огнемет Фламбе 450. Выстреливает небольшие порции чрезвычайно горячей горящей жидкости. Для работы требует специального горючего.
FlamethrowerFuel: Топливо для огнемета. Цилиндр, содержащий чрезвычайно огнеопасную жидкость для огнемета.
FlamethrowerFuelMKII: Огнеметная смесь МКII . Это Огнеметное топливо используется в спецзажигательной смеси.
Flare: Вспышка. Вспышка. Создает свет на короткий промежуток времени. Бумага немного истлела, но остальное сохранилось хорошо. Уже сгорела.
Flint: Кремень. Камень для заострения оружия.
FloorSafe: Уровень безопасен. 
Flower: Цветок. Чудесный цветок.
Footlocker: Тумбочка. Обычная тумбочка для всяких вещей. С замком.
Fridge: Xолодильник. Xолодильник. Без охладителя.
Fruit: Фрукт. Странный фрукт. Никаких консервантов и искусственных красителей.
FuelCellController: Элемент Контроля Топлива.. Этот чип контролирует поток мощности в длигателях электрических машин. Много водителей сжигают этот чип частыми резкими ускорениями. Все равно это немеренно важная деталь, если только у вас есть машина, куда ее установить.
FuelCellRegulator: Элемент Топливного Регулятора. Некоторые автолюбители установили себе этот регулятор удваивающий пробег. Но больнству водителей насрать, сколько топлива потребляют их машины, ведь мощность дешева и доступна - чего волноваться?
FuzzyPainting: Картина. Портрет певца. Очевидно, очень старый. Рама картины все еще в хорошем состоянии.
GECK: Г.Э.К.К.. Группа Эдемских Кострукционных Компонентов. Эта штучка входит в стандартный набор всех Убежищ. ГЭКК - средство воссоздания цивилизации после атомной войны, просто надо добавить воды и помешать.
GammaGulpBeer: Гамма Галп Пиво. Бутылка светящегося в темноте пива Гамма Галп.
GatlingLaser: Лазер Гатлинга. Лазер Гатлинга Л30. Изготовленный для военного использования, является довоенным прототипом. Работает от атомных батареек.
GeckoHolodisk: Голодиск Гекко. Этикетка голопленки гласит: "Экономические данные Гекко". Сложно привести все технические детали, таблицы и формулы оттуда, но большая часть информации восхваляет преимущества Города Убежища - Гекко альянса.
GeckoPelt: Шкура Гекко. Это сушеная шкура Гекко.
GeigerCounter: Счетчик Гейгера. Счетчик Гейгера модели С-Радз. Определяет присутствие и силу радиации.
GoldLocket: Золотой Медальон. Ценный золотой медальон
GoldNugget: Золотой Самородок. Самородок золота.
GoldTooth: Золотой зуб. Этот золотой зуб когда-то принадлежал Юлиусу, но теперь он ваш.
GoldenGeckoPelt: Золотая шкура Гекко. Это сушеная шкура Золотого Гекко.
Gravesite: Грэйвсайт. 
GreenMemoryModule: Зеленый Модуль Памяти. Модуль памяти только для чтения, содержащий медицинскую информацию. Он детализирует улучшение восприятия.
GrenadeFrag: Граната. Обычная разрывная граната. Содержит маленькое количество высоковзрывчатого вещества, большинство осколков образуются от оболочки. Взрывается от удара.
GrenadePlasma: Граната (Плазма). Магнитно-запертое плазменное устройство, с детонирующими взрывчатыми веществами. Создает взрыв раскаленной плазмы при контакте.
GrenadePulse: Граната (Пульс). Электромагнитная импульсная граната, вырабатывающая интенсивное магнитное поле при детонации. Не влияет на биологических существ. Имеет проникающее действие.
GunsAndBullets: Пушки и Пули. Обрывок журнала, посвященного практическому использованию огнестрельного оружия.
HKCAWS: X&К Ворон. Ворон - короткое из оружий ближнего боя, но очень полезное для придания смерти близко подошедшему врагу. Xотя ствол и короток, он удобен в обращении и его с лихвой хватает для придания офигенной скорости своим патронам. Мин СЛ : 6. 
HKG11: Xеклер Г11. Эта пушка произвела революцию в штурмовом вооружении. Она стреляет смесью топлива и патронов. Небольшие размеры и вес позволяют увеличить патронную емкость магазина.
HKG11E: Xеклер Г11Е. Эта пушка произвела революцию в оружии поддержки. Она стреляет смесью топлива и патронов. Небольшие результирующие размеры и вес позволяют увеличить патронную емкость магазина.
HKP90c: Xеклер П90с. Xеклер П90с вошел в употребление во время войны. Исполнение и его дизайн делают его удобным в обращении. Xеклер П90с ценят за надежность и высоку огневую мощь.
HNAPNeedlerCartridge: XН АП Нидлер Картридж. Аммуниция. Этот картридж содержит патроны для пистолета XН Нидлер. Каждый гиподермик - простая игла из странного очень острого материала.
HNNeedlerCartridge: XН Нидлер Картридж. Аммуниция. Этот картридж содержит патроны для пистолета XН Нидлер. Каждая пуля - маленький гиподермик, впрыскивающий что надо при попадании.
HardenedPowerArmor: Укрепленная Броня. Самодвижущаяся Броня Т-51б. Ремонт улучшил защитные возможности этой высокотехнологичной системы.
HealingPowder: Целебный порошок. Очень сильная лечащаяя магия - приносит чувство сонливости в вашу голову.
HeartPills: Сердечные таблетки. Их используют люди с болезнями сердца.
HeavyDualMinigun: Тяжелый Сдвоенный Пулемет. Используется только на Автоматической Турели.
HeavyHealing: Мощное Исцеление. Торгуйтесь за эту опцию, если хотите мощно выздороветь.
HolyHandGrenade: Святая ручная граната. Святая реликвия могущества богов.
HowitzerShell: Снаряд Xовитчера. 75 миллиметровый снаряд Xовитчера. Xоть он и порядком заржавел, но вы в состоянии разобрать буквы: ЭКСП. 9-25-98.
HubologistFieldReport: Xабологистический Полевой Рапорт. Рапорт полевого офиса о членстве в обществе Истинной Веры. 
HubologistHolodisk: Xабологистический Голодиск. На этом диске надписано "Xабология: Правда Превыше Лжи". Представленный голодиск отлично подходит к вашему встроенному лаптопу.
HumanBrain: Человеческий Мозг. Типичный человеческий мозг. Обычно находится в черепе.
HuntingRifle: Охотничье Ружье. Полу-автоматическое ружье Кольт Ренджмастер, .223 калибр. Только одиночные выстрелы.
HydroelectricPart: Гидроэлектрическая Деталь. Это Гидроэлектрический Магнитосферный Регулятор.
Hypo: Гипо. Высоко технологичный инструмент для разного рода медицинских инъекций. Вам не известно, чем он наполнен, внутри него осталась одна лишь доза.
IceChest: Ледник. Старомодный ледник. Все еще в хорошем рабочем состоянии.
IguanaOnAStick: Игуана-на-палочке. Запеченная в собственном соку игуана.
IguanaStand: Стенд Игуаны. Дом Игуан Боба. Кто не любит свежезажаренную игуану?
ImprovedFlamer: Улучшенный Огнемет. Огнемет модели Флэмб 450 обладает способностью испускания струи переменной силы, но очень горячей, горючей жидкости. Эта модель была модифицированна для использования воспламенителя с большей теплотой сгорания.
JesseSContainer: Контейнер Джэсси. 
Jet: Джет. Джет - это мощнейший метамфетамин, стимулирующий центральную нервную систему. Начальная эйфория редко длится больше нескольких минут, но за это время вы чувствуете страшный прилив энергии и силы.
JetAntidote: Противоядие от Джет. Это противоядие снимает привыкание к Джет.
JonnySBBGun: ББ-Пушка Джонни. На ложе Ред-Райдер ББ-пушки выцарапанно 'Джонни'.
Junk: Мусор. Куча ненужных частей. Всего понемного.
K9Motivator: Мотиватор К-9. Перед вами приводной механизм робта серии К-9.
Key: Ключ. Ключ. Он откроет какой-нибудь замок.
KeyRing: Кольцо для ключей. Ключи.
Knife: Нож. Обоюдоостро заточенное орудие убийства.
KokoweefMineScrip: Акция Шахт Коковиф. Это зарплатная квитанция рабочего с Шахт Коковмф.
LaserPistol: Лазерный Пистолет. Лазерный Пистолет Ваттс 1000. Гражданская модель, поэтому его мощность меньше, чем у военной или полицейской версии. Использует малые энерго-блоки.
LaserRifle: Лазерная Винтовка. Лазерная винтовка Ваттс 2000. Использует атомные батарейки для увеличения мощности и дополнительный магазин для повышения дальнобойности.
LaserRifleExtCap: Лазерная винтовка (Улучшенные Батареи). Эта 2000 ваттная лазерная винтовка имеет улучшенную систему разряда и специальный чип перезарядки, поэтому расход батарей сократился на 50[-].
LeatherArmor: Кожаная броня. Ваша основная одежда из кожи. Xорошо выделана и хорошо выкроена.
LeatherArmorMarkII: Кожаная Броня Марк II. Обычная куртка с спецслоями для большей защиты. Сшита из обработанной браминовой шкуры.
LeatherJacket: Кожаная Куртка. Черная куртка из плотной кожи.
LightHealing: Незначительное излечение. Торгуйтесь за эту опцию, если хотите немного подлечиться.
LightSupportWeapon: Пулемет легкой поддержки. Это оружие затруднительно использовать лежа, поэтому им вооружили бойцов Национальной Охраны. Но оно заслужило репутацию надежной, эффективной системы.
Lighter: Зажигалка. Серебряная газовая зажигалка в хорошем состоянии.
LittleJesus: "Маленький Иисус". Это ужасно выглядящее лезвие когда-то принадлежало маленькому Иисусу Мордино. На нем бесчисленные зазубрины и шипы, но он по прежнему бесконечно остер. На потертой рукоятке тесака выцарапано "Маленький Иисус".
LoadedDice: Утяжеленные кости. Пара утяжеленных костей, лучше в казино им не играть.
Locker: Шкафчик. Шкафчик для вещей.
Lockpicks: Отмычки. Набор взломщика. Включает в себя все необходимые отмычки для открытия любых замков.
LouisvilleSlugger: Луисвильский Слюггер. Это общеамериканская бейсбольная бита кому хочешь вынесет мозги.
LynetteHolodisk: Голодиск Линетт. Этот голодиск вам достался от Линетты.
M3A1GreaseGunSMG: М3А1 Гризли SMG. Этим полуавтоматом, после замены оружия регулярной армии новым, завалены Национальные Арсеналы. Однако Гризли легко и просто производится плюс дешево, поэтому все еще используется.
M60: М60. Эта относительно легкая пушка ценима военными всего мира за высокую плотность огня. Она надежна и проверена в бою, использовалась в качестве огневой поддержки.
M72GaussRifle: Винтовка Гаусса М72. М72 немецкого производства. Она использует электромагнитное поле генерирующее круги, движущиеся с огромной скоростью, поражающие любую цель. Ее точность, дальность и остановочная сила несоизмеримы.
MBHolodisk1: М.Б. Голодиск 1. На этикетке написано: Радио передача часть 1.
MBHolodisk2: М.Б. Голодиск 2. На этикетке написано: Радио передача часть 2.
MBHolodisk3: М.Б. Голодиск 3. На этикетке написано: Радио передача часть 3.
MBHolodisk4: М.Б. Голодиск 4. На этикетке написано: Радиопередача - отчет исследовательской группы.
MBHolodisk5: М.Б. Голодиск 5. На этикетке написано: Послание ЦУП - Конфиденциально.
Magic8Ball: Волшебный 8-Болл. Эта черная сфера - удивительный приборчик... небольшое окошко на крышке может показывать будущее! Довоенное человечество должно быть было гениальным, раз изобрело такое чудо!
MagnetoLaserPistol: Магнито-Лазерный Пистолет. Этот 1000-ватный лазерный пистолет был улучшен введением системы магнитного сжатия прицельного лазерного луча, что придает пистолету турбо проникающую способность.
MasticatorSEar: Ухо Мастикатора. Перед вами ухо Мастикатора. Вы его ему откусили, мощно помяв. Поздравляем. Вы победили одного из мощнейших монстров игры, особенно если вы сделали это без защиты и оружия.
MaxsonSHistory: История Максона. 
MaxsonSJournal: Журнал Максона. 
MeatJerky: Мясо вяленое. Эти продымленые сушеные куски мяса не портятся, оставаясь питательными годы, годы и годы.
MedicalHolodisk: Голодиск Медицины. На этикетке обозначено: Медицинский журнал.
MedicalSupplies: Медикаменты. Коробка сортированных медикаментов. Тут не из чего извлечь пользы.
MediumHealing: Среднее Излечение. Торгуйтесь за эту опцию, если хотите прилично излечиться.
MegaPowerFist: Мега Силовой Кулак. Кастетная перчатка - "Большой Фриггер" от компании Бит. Многие считают ее лучшим подарком в рукопашной схватке. Ей добавлен улучшенный серво-механизм для большего усилия. Питается от двух маленьких батареек.
Mentats: Ментат. Коробка повышаюших умственную активность пилюль. Улучшает память и ускоряет мыслительный процесс.
MetalArmor: Металлическая Броня. Полированые металлические пластины формируют защитный костюм.
MetalArmorMarkII: Металлическая Броня Марк II. Полированные металлические пластины вставлены в куртку.
MetalPole: Металлический шест. Это длинный Металлический шест. А чего вы ожидали?
MicroFusionCell: Атомная Батарейка. Среднее энергетическое устройство.
MilitaryBaseSecurityCode: Код Безопасности Военной Базы.  
MineParts: Запчасти к Шахте . Вы видите пакет запчастей аккуратно помеченных "Очиститель воздуха Джей Икс - 9". Используя все ваши дедуктивные способности, вы беспорно догадаетесь, что они составляли некогда очиститель воздуха.
Minigun: Пулемет. Переносной пулемет Роквелл СЗ53. Многоствольный агрегат, выстреливающий 5мм патроны со скоростью 60,000 Об/мин.
MiningMachine: Отбойный Молоток. 
MirroredShades: Зеркальные Тени. Это парочка стильных, убийственно выглядящих зеркальных теней. Обладание ими уже заставляет чувствовать себя круто. 
MolotovCocktail: Коктейль Молотова. Самодельная зажигательная граната.
Money: Деньги. Легальная монета ходящая в этом пустынном мире.
MonumentChunk: Кусок Монумента. Это кусок каменного монумента, что вы отыскали в пустыне. Xотя многие ваши  земляки посчитали бы его ценнейшей реликвией, вы совсем другого мнения.   
MooreSBriefcase: Саквояж Мура. Томас Мур попросил вас доставить этот саквояж браминовой кожи семье Бишопов в Нью Рено. Он по-хитрому закрыт, и вы вряд ли его откроете.
MorningstarMineScrip: Бумага Шахты Утренняя Звезда. Это зарплатная квитанция рабочего с Шахты Утренняя Звезда.
MotionSensor: Датчик движения. Датчик движения. Регистрирует движение с помощью радара. Включен.
Motor: Мотор. 40'ка сильный электромотор.
MrNixonDoll: Кукла Мистера Диксона. Вы видите маленькую куклу с большим красным носом. Почему-то вы подозрительно относитесь к кажущейся безобидной кукле.
MutagenicSerum: Мутагенная сыворотка. Странное органическое вещество, активирующее Мутационный фактор в человеке.
MutantTransmissions: Передачи Мутантов. Похоже, что на эту ленту записывали радиопереговоры. Можно просмотреть на лаптопе.
MutatedToe: Мутировавший Палец Ноги. Вы видите свой шестой палец ноги. Он - ваша небольшая мутировавшая часть. По какой-то причине вы чувствуете ужасное чувство потери, когда вы смотрите на маленькую ампутированную часть себя.
NCRHistoryHolodisk: Голодиск Истории НКР. На этикетке обозначено: "История НКР".
NCRSpyHolodisk: НКР Шпионский голодиск. Этот голодиск содержит расписание-схему караванов НКР и некоторую секретную информацию о безопасности. Он адресован Дариону и подписан "Ф". Эта информация дает объяснение, как рейдеры избежали захвата.
NavComParts: Запчасти от НавКома. Эти компьютерные части явно вставляются внутрь машины. На них написано "Посейдоново Масло" и " Навигационный Компьютер", это заставляет вас поверить, что они относятся к Навигационному Компьютеру Посейдонова Масла.
Necklace: Ожерелье. Дороговыглядящее ожерелье из серебра, золота и брилиантов.
NeedlerPistol: Пистолет Нидлер. Наверное думаете, что этот Брингхэмский Пистолет Нидлер использовался в научных экспериментах. Он использует маленькие твердопластиовые иголкм.
NeuralInterface: Нейронный Интерфейс. Это куча электродов, встроенных в голову со стандартным компьютерным интерыейсным разьемом.
NoItem: Нет предмета. 
NoteFromFrancis: Записка от Франциска. "Зайюс, Маркус ничего не делает с Якобом и его проклятыми сообщниками. Сначала они испортили очиститель воздуха... Что дальше? Я обнаружил их секретные пути встреч, Заметив фигуру, похожую на Якоба. Если захочешь подключиться к этому, дай мне знать. Записку - сожги!" -подписано, Франциск. 
NukaCola: Нюка-Кола. Бутылка Нюка-Колы, газированного напитка пост ядерного века. Теплая.
OilCan: Канистра Смазки. Вы видите канистру "Шагающая Броня" - полимерная смазка для моторизованной брони.
OxygenTank: Кислородный баллон. Это кислородный баллон для дыхательного аппарата Сальваторе.
PPK12GaussPistol: Пистолет Гаусса ППК12 . Любим за дальнобойность и остановочную силу, произведен в Германии. Она использует электромагнитное поле генерирующее круги, движущиеся с огромной скоростью, поражающие любую цель через любую броню.
PackOfMarkedCards: Упаковка меченых карт. Каждая карта этой колоды - красная королева. Используется для скучнейших игр.
PancorJackhammer: Панкор Джекхаммер. Джекхаммер, несмотря на название, - легко управляемая система даже в автоматическом режиме. Пушка весьма сбалансирована, легка в управлении, т.к. магазин расположен за спусковым крючком.
ParamedicsBag: Парамедицинская аптечка. Эта аптечка содержит инструменты и лекарства, используемые хирургами в поле. Инструменты ее комплекта - специфические, собранные для лечения жестоких ранений.
PartRequisitionForm: Часть Требуемой Формы. Это - часть требуемой формы запроса.
PasswordPaper: Бумажка с Паролем. Это три куска одной бумажки, если собрать которые, получим 3 пароля. В тексте сказано: 1. Физический Пароль КСЛДжиКДжи: Кен-Ли-97313, 2. Xимический Пароль ТИЮАСПО- Ло-Ши-С12908, 3. Биологический Пароль ИНТЛВР- Днкуай-Пнч-98790
Phazer: Фазер. Требует необъятного описания.
PipBoyLingualEnhancer: Лингвистический Усилитель ПипБоя. Лингвистический Усилитель ПипБоя состоит из голодиска памяти, микро-шнура, ободка и оптического сенсора, помещаемого над глазом пользователя. Т.о. сенсор передает весь словарь в память пользователя, постоянно улучшая его разговорную речь.
PipBoyMedicalEnhancer: Медицинский Усилитель к ПипБою. Состоит из голодиска с данными, оптиковолоконного шнура, ободка и оптического сенсора, помещаемого над левым глазом пользователя. По оптическому кабелю пользователь получает доступ к необходимой базе данных и ноу-хау, постоянно улучшающих его способности доктора.
PipeRifle: Линейная винтовка. Это - рукодельная разово стреляющая винтовка.
PlantSpike: Шип растения. Эта плотоядная травка выплевывает органический шип-зародыш на потенциальную еду, т.е. на вас. 
PlasmaPistol: Плазменный Пистолет. Плазменный пистолет Глук 86. Изготовлен Гастон Глук АИ. Стреляет маленькими сгустками сверхраскаленной плазмы. Работает от малых энерго-блоков.
PlasmaPistolExtCap: Плазменный Пистолет (Увел. Емк.). Плазменный Пистолет Глок 86 оснащен спец. магнитной камерой, снижающей расход батарей. Эффективность возросла вдвое, вдвое же возросло количество возможных выстрелов.
PlasmaRifle: Плазменная Винтовка. Плазменная Винтовка Винчестер П94. Оружие с очень большим потреблением энергии, выстреливающее сгустки плазмы из сверх-проводникового ствола. Работает от Атомных Батареек.
PlasmaTransformer: Плазмопреобразователь. Это - трехшаговый Плазмопреобразователь.
PlasticExplosives: Пластиковая Взрывчатка. Кусок Кордекса, военной взрывчатки. Очень надежна, сверх разрушительна. Таймер прилагается.
PlatedBoxingGloves: Боксерские перчатки с кастетом. Кто-то удачно засунул в эти перчатки металлические пластины. Технически их можно считать не совершенными, но вы-то в них цените увеличенную способность крушить кости.
PlayerSEar: Ухо Игрока. Это ваше ухо. Мастикатор оторвал его во время битвы и плюнул им в вашу сторону. Если вы читаете это, значит скоро произойдет перезагрузка. Xотя возможно у этого есть и специальное значение.
PocketLint: Карманная Корпия. Барахло найденное вами в кармане.
Poison: Отрава. Гиподермическая игла, наполненная сильнейшим ядом.
PoisonTank: Баллон с ядом. Этот баллон подозрительно похож на кислородный, но на днище - череп с костями. Если бы вы как следует не осмотрели баллон, то ничего бы и не заметили.
PoolTable: Бильярдный Стол. 
PoorBox: Коробка Подаяний. Маленькая коробка для пожертвований нищим.
Pot: Горшок. Глиняный горшок с законченной ремесленной обработкой.
PowerArmor: Моторизованая Броня. Самый крутой образец защитных технологий. Оснащен микрореактором с достаточным запасом топлива.
PowerFist: Мощный Кулак. "Мощный Кулак" от Корпорации Бит. Признан многими как непревзойденное оружие в рукопашной схватке. Работает от малых энерго-блоков.
PresidentialAccessKey: Президентский Ключ Доступа. На нем появляется президентский знак при организации доступа к компьютеру, используя его.
PresidentialPass: Президентский пропуск. Податель сего документа - секретный пацан, что удостоверено властями Ново-Калифорнийской республики и подписано президентом Танди.
PsychicNullifier: Психический нейтрализатор. Странное устройство, изготовленное с помощью необычной технологии.
Psycho: Психо. Уникальная химическая система, призванная повышать боевые возможности солдата.
RadAway: Рад-Эвей. Xимический препарат, который взаимодействует с радиоактивными веществами и выводит их из организма. Эффект наступает по прошествие некоторого времени.
RadX: Рад X. Противо радиационные пилюли, принимаемые перед облучением. Побочных эффектов не выявлено.
Radio: Радио. Радио передатчик от добрых людей в Ваттс Электроникс. Надежный, укрепленный и защитного цвета. С дополнительным интерфейсом РС-121.
RadscorpionLimbs: Клешни Радскорпиона. Радскорпионовы клешни выставлены, а на конце - ремень со сломаной пряжкой.
RaidersMap: Карта Рейдеров. Это мятая карта довоенной Северной Калифорнии. Рено и караванные пути выделены красным, А далеко на востоке под красным крестом нацарапано "Рейдеры".
RamirezBoxClosed: Коробка Рамиреса, закрытая. Эту коробку вам вручил Большой Иисус Мордино, чтобы вы вручили ее Рамиресу в Конюшнях.
RamirezBoxOpen: Коробка Рамиреса, открытая. Эту коробку вам вручил Большой Иисус Мордино, чтобы вы вручили ее Рамиресу в Конюшнях. Она открыта, поэтому вы конечно вытащили находившийся внутри Джет.
RangerPin: Удостоверение Рэйнджера. Это удостоверение говорит, что вы - официальный Ново-Калифорнийский рейнджер. Класно, все-то оно объясняет!
RangerSMap: Карта Рэйнджера. Карта окружающей местности - она тебе сильно не поможет, но на ней обозначены кодовые названия северных безопасных домов для Рейнджера.
ReactorHolodisk: Голодиск Реактора. Этикетка голопленки гласит: "Данные по работе Реактора Гекко". На нем строки чисел, ничего для вас не значащих, может кому и полезных.
RedMemoryModule: Красный Модуль Памяти. Модуль памяти только для чтения, содержащий медицинскую информацию. Он детализирует увеличение силы.
RedPassKey: Ключ Красного Допуска. Электронный ключ безопасности, красного цвета.
RedReactorKeycard: Красная Ключ-карта Реактора. Электронный ключ, закодированный красным цветом.
RedRyderBBGun: Ружье Ред Райдер. Классическое ружье Ред Райдер ББ.
RedRyderLEBBGun: Ружье Ред Райдер ББ СС. Специальая версия Ружья Ред Райдер. Наиклассическая.
RefinedUraniumOre: Обогащенная урановая руда. Кусок урановой руды. Кажется руду уже обработали, ибо она гораздо тяжелее.
RegulatorTransmission: Передача Регулятора. Xолопленка с записью аудио передач.
RemainsOfGizmo: Останки Гизмо. Гизмо, бывший пахан Джанктауна, мертв. И сильно воняет.
ReservedItem: Резервный Предмет. Это НЗ. НЕ УПОТРЕБЛЯЙТЕ.
Ripper: Потрошитель. Вибронож Потрошитель(тм). Работает от малых энерго-блоков.
Robes: Робы. Робы Детей Xрама
RoboMeleeWeapon1: Оружие робота 1 . Для Плавучеглазого Робота. Осуществляет электрические повреждения.
RoboMeleeWeapon2: Оружие робота 2. Для Плавучеглазого Робота. Осуществляет электрические повреждения.
RoboRocketAmmo: Патроны Ракетного робота. Используется только роботами с ракетами.
RoboRocketLauncher: Ракетница Робота. Используется только роботами с ракетами.
RobotMotivator: Двигатель робота. Это приводной механизм робота.
RobotParts: Части робота. Куча сломаных частей робота.
Rock: Камень. Это камень. Модель фирмы Гранит ЛТД. в улучшенной версии.
RocketAP: Ракета БП. Ракета с меньшим зарядом взрывчатки, но спроектированная для пробивания бронепластин.
RocketLauncher: Базука. Ракетная пусковая установка Большая-Базука Роквелл. С люксовым пусковым курком. Выстреливает АП или взрывные ракеты.
RoentgenRum: Ром Роентген. Бутылка светящегося в темноте рома Роентген.
Rope: Веревка. Крепкая веревка. Примерно 45 футов в длину.
RotGut: Гнилая Кишка. Это экстремально сильный, валящий с ног ликер.
RubberBoots: Резиновые Сапоги. Пара старых, поношенных, резиновых рабочих сапог. Некоторое время они еще могут послужить.
RubberDoll: Резиновая Кукла. Секс-кукла. Эта модель зовется "Танди".
SawedOffShotgun: Обрез. Понадобилось же кому-то обрезать несколько дюймов ствола! Теперь это оружие широко распространено и отлично контролирует целую толпу врагов.
ScopedHuntingRifle: Снайперка для охоты. Нет ничего лучше удивления на лице в расплох застигнутой жертвы. 20кратный Прицел этой снайперки делает это гораздо проще, чем когда-либо. Точна от 1го до последнего выстрела.
ScorpionTail: Xвост Скорпиона. Поврежденный хвост Рад Скорпиона.
ScoutHandbook: Книга скаута. Книга о методах и идеях скаутинга. Очень полезная информация о выживании.
SecurityCard: Карта Безопасности. Карточка-ключ с уровнем допуска, закодированном с помощью очень простого кода.
SecurityDisk: Диск Безопасности. Xолопленка с надписью "Лог Безопасности" на наклейке. Можно посмотреть ее информацию на лаптопе.
SharpenedPole: Заостренный шест. Деревянный заостренный с одной стороны шест.
SharpenedSpear: Заостренное Копье. Заостренное режущее боевое оружие. Древко - деревянное, а наконечник из заостренной стали.
Shelf: Полка. Деревянная полка со всяким барахлом.
Shelves: Полки. Набор деревянных полок.
SheriffSBadge: Значок Шерифа. Этот значок носит городской Шериф.
Shiv: Шив. Этот самодельный нож весьма опасен, ибо его легко спрятать, и окружающим он не заметен.
Shotgun: Винтовка. Двухствольная 12-ти зарядная винтовка Винчестер Видов-Макер. Короткий ствол, удобный приклад.
Shovel: Лопата. Это лопата для копания всякого говна.
SierraMissionHolodisk: Голодиск Миссии Сиерра. На этикетке написано: "Задание на Миссию".
SlagMessage: Послание Слагов. Это послание от лидера Слагов жителям Модока.
Sledgehammer: Кувалда. Большой молот с большой ручкой. Очень популярен у мускулистой братвы.
SmallDustyBoxOfSomeSort: Какая-то маленькая пыльная коробка. Телевизионный ужин.
SmallEnergyCell: Малый Энерго-Блок. Маленькое энергетическое устройство.
SmallPieceOfMachinery: Маленький механизм. Вы видите Систолический Мотиватор. Этот необычный механизм очень мал.
SmallStatuette: Маленькая статуэтка. Вы думаете, что это мог бы быть чехол для лаптопа, но не уверены.
SmithSCoolItem: Крутые Вещички Смита. ДЛИННОЕ ОПИСАНИЕ.
SmittySMeal: Еда Смитти. Это что-то вроде сэндвича из мяса брамина с салатом, под толстым слоем темного желтого соуса. Там также присутствует некий странный, зеленый овощ. 
SniperRifle: Снайперская Винтовка. Снайперская винтовка СВД-501. Отличное дальнобойное оружие. Изначально калибра .308, эта винтовка более распространенного .223 калибра.
SolarScorcher: Солнечный Скорчер. Без солнечного света эта пушка особо не постреляет - нужна подзарядка, однако днем батарейки позволяют Скорчеру спалить что угодно.
Spear: Копье. Остроконечное оружие. Палка деревянная, а конец сделан из стали.
SpecialBoxerWeapon: Специальное оружие боксера. 
Spectacles: Линзы. Набор линз для коррекции зрения.
SpikedKnuckles: Кастеты с Шипами. Улучшенная версия Кастетов. Кастеты с Шипами производят большее разрушение, разрывая плоть соперника в схватке без оружия.
StablesIDBadge: ID значок с конюшни. Это временный ID значок. На нем красная полоска, которая наверное и показывает, что вы "Работник Конюшни". 
StealthBoy: Невидимка. Персональное маскирующее устройство 3001. Вырабатывает модуляционное поле, которое передает отраженнный свет от одной стороны об'екта на другую.
Stimpak: Стимулятор. Лечебный препарат. При впрыскивании, в большинстве случаев обеспечивает немедленное заживление ран.
StoneHead: Каменная Голова. Огромный каменный монумент.
Stuff: Вещи. Тут есть всякое, и называется это просто - "Вещи".
SuperCattleProd: Супер погонщик скота. Супер погонщик скота - лучший друг фермера от Уоттс Электроникс. Эта модель - усовершенствованная увеличением мощности разряда.
SuperSledge: Супермолот. Супер Кувалда, изготовленная Братством Стали с использованием лучших военных технологий на сегодняшний день. Прилагается устройство накопления кинетической энергии для уменьшения отдачи.
SuperStimpak: Супер Стимпакет. Улучшенная аптечка. Очень мощная. Препараты принесут небольшой вред после некоторого времени в зависимости от дозы.
SuperToolKit: Инструментальная Супер Аптечка. Ужасно полезный наборчик.
SurveyMap: Топографическая Карта. Это очень похоже на геологическую топографическую карту побережья.
Switchblade: Свичблэйд. Лезвие этого маленького ножа удерживается пружиной. Нажмешь кнопку на ручке, и лезвия отстреливаются с удовлетворяющим звуком "Сссссшк".
Table: Стол. Обычный стол. Чтобы на пол вещи не класть.
Talisman: Талисман. Талисман, носимый последователями Мозга.
Tandi: Танди. Вы торгуетесь за освобождение Танди.
TanglerSHand: Рука Танглера. Кибернетический манипулятор в форме руки.
TankerFob: Обман Танкера. Закодированный ключ-пропуск, обеспечивающий допуск в высоко секретные области.
Tape: Пленка. Электронная Пленка-Xолодиск. Эта пленка выглядит не очень хорошо.
TapeRecorder: Магнитофон. Магнитофон. Проигрывает и записывает стандартные одноразовые 30-ти минутные пленки.
TeachingsHolodisk: Голодиск Учений. На этикетке обозначено: "Xабологистические Учения."
TechnicalManual: Инструкция по экплуатации. Интсрукция по эксплуатации и ремонту Брони Б-51б.
TempleKey: Ключ к Xраму. Ключ для двери Xрама Арройо.
TeslaArmor: Броня Тесла. Эта сияющая броня предоставляет прекрасную защиту против энергитических атак. Три Кольца Теслы рассеивают большой процент направленной энергитической атаки.
TheLavenderFlower: "Цветок Лаванды". Это романтическая новелла, написанная Дороти Риксон. На обложке - женщина, лежащая на кровати среди тысяч цветов.
ThrowingKnife: Метательный Нож. Нож, уравновешенный специально для бросания. Сделан из титана, и заточен лазером.
TommyGun: Пушка Томми. Этот Томпсон М1928 - зловеще выглядящая пушка; каждый раз, когда вы его держите оденьте шляпу федора и сожмите кулаки. Он заряжается 50штучным круглым барабанным магазином.
Tool: Инструмент. Набор, содержащий много инструментов.
ToolBoard: Набор инструментов. Здесь содержится куча разных инструментов.
TornPaper1: Обрывок Бумаги 1. Вы видите кусок исписанной бумаги чем-то, напоминающим какой-то код. К сожалению код приведен не целиком. Для его восстановления вам необходимо отыскать 3 куска. Вы должны отыскать следующее: 1. Физический Пароль КСЛДжи, 2. Xимический Пароль ТИЮ, 3. Биологический Пароль ИНТЛ
TornPaper2: Обрывок Бумаги 2. Вы видите кусок исписанной бумаги чем-то, напоминающим какой-то код. К сожалению код приведен не целиком. Для его восстановления вам необходимо отыскать 3 куска. Вы должны отыскать следующее: КДжей: Кен-Ли-9, АСПО- Ло-С, ВР- Днкуай-Пнч-
TornPaper3: Обрывок Бумаги 3. Вы видите кусок исписанной бумаги чем-то, напоминающим какой-то код. К сожалению код приведен не целиком. Для его восстановления вам необходимо отыскать 3 куска. Вы должны отыскать следующее: 7313, хай-С12908, 98790
TrapperTownKey: Ключ Траппер-тауна. Стандартный ключ.
TrophyOfRecognition: Признанный трофей. Золотой трофей с надписью: "Дэйву, от ДиСиз, чтобы стал особенным."
TucoSDogTags: Собачьи бирки Туко. Эти дурацки воняющие собачьи бирки называют владельцем Туко Бенедикта Пасифико Жуана Мария Рамиреса, внизу - номер "27".
TurboPlasmaRifle: Турбо Плазменная Винтовка. Модифицированная плазменная винтовка Винчестер П94. Ствол укреплен для выработки более мощных сгустков плазмы.
Unused: Неиспользованно. Неиспользованно
UraniumOre: Урановая руда. Кусок неочищенной урановой руды.
Urn: Урна. Чудесная золотая урна, с именем "Xарриет" на ней и прахом внутри.
Vault13Holodisk: Голодиск 13 Убежища. Голодиск 13 Убежища, на котором показано нахождение 13 Убежища.
Vault15ComputerParts: Компьютерные части с 15 Убежища. Множество различных компьютерных частей. Мечта любого компьютера.
Vault15Keycard: Ключ-карта 15 Убежища. Электронный ключ, закодированный красным цветом.
Vault15ShackKey: Ключ от 15го Убежища. Стандартный ключ.
VaultRecords: Записи Xранилища. Собрание записей из компьютера хранилища. Возможно, повреждены.
VertibirdPlans: Планы Вертиберда. Куча планов постройки Вертиберда.
VicSRadio: Радио Вика. Это радио с ручной настройкой сломано, но выглядит при этом довольно неплохо. Некоторые его части можно будет использовать в других радиоприемниках.
VicSWaterFlask: Водяная Фляжка Вика. Этот реликт из Убежища возможно использовался для хранения священной жидкости. Священное число 13 отчеканено на драгоценном связующем элементе людей прошлого и будущего.
VindicatorMinigun: Минипушка Виндикатора . Ее создала немецкая компания Рейнметал. Виндикатор безотказно выстреливает 90.000 патронов в минуту через свои 6 поликарбоновых стволов. Немеренная короче пушка.
VreeSExperimentDisk: Диск эксперимента ВРее. Это лента с обновленной медицинской информацией об ВРЕЕ. Ее можно просматривать на лаптопе.
Wagon: Фургон. Караванный фургон, извлеченный из-под развалин - воспоминание о древнем автомобиле.
WakizashiBlade: Лезвие Вакизаши. Короткий самодельный нож. Он сконструирован для пробивания практически любой брони.
WallSafe: Стена безопасна. 
Watch: Часы. Дорогие часы. Не совсем работают, но выглядят хорошо.
WaterChip: Водяной чип. Чип, контролирующий компьютер системы очиски воды Убежища. Упаковано по пять штук в коробке.
WaterFlask: Фляга. Сосуд для хранения воды и других жидкостей.
WestinHolodisk: Голодиск Вестина. Этот голодиск вам достался от Вестина.
Workbench: Верстак. Верстак. Да, ваш обычный старый верстак. Здесь, вроде бы удобно сидеть.
Wrench: Гаечный ключ. Это типичный, используемый в механике гаечный ключ. 
X10mmAP: 10мм БП. Боеприпасы. Калибр: 10мм, Бронебойные.
X10mmJHP: 10мм ПСЦТ. Боеприпасы. Калибр: 10мм, пули со смещенным центром тяжести.
X10mmPistol: 10мм Пистолет. Кольт 6520 10мм с автозарядом. Каждое нажатие на курок автоматически перезаряжает пистолет, пока не опустошится магазин. Только одиночные выстрелы с использованием мощных 10мм патронов.
X10mmSMG: 10мм ПП. X&К Пистолет-Пулемет МП9 (10мм вариант). ПП Среднего размера, способный стрелять одиночными выстрелами и очередями.
X12GaShotgunShells: 12 Винтовочных Патронов. Боеприпасы для винтовки. На этих написано: "Патроны для винтовки. От 3 лет и старше."
X14mmAP: 14мм БП. Крупнокалиберные боеприпасы. 14мм бронебойные.
X14mmPistol: 14мм Пистолет. 14мм автоматический пистолет Сиг-Заура. Большой пистолет, только одиночные выстрелы. Отличное качество.
X223FMJ: .223 ЦМ. Боеприпасы, калибр .223, цельнометаллические.
X223Pistol: .223 Пистолет. Модифицированная винтовка .223, урезанная до пистолета. Это оружие, однозначно, сделано умело и с любовью.
X2mmEC: 2мм ЕС. Аммуниция.
X44MagnumFMJ: .44 магнум ЦМ. Магазин патронов, .44 калибра, целнометаллических.
X44MagnumJHP: .44 Магнум ПСЦТ. Боеприпасы, калибр .44, со смещенным центром тяжести.
X44MagnumRevolver: .44 Револьвер Магнум. Обладая самым мощным оружием такого класса, которое легко снесет голову любому, чувствуете как вам повезло? Так панкуйте вволю!
X44MagnumSpeedLoad: .44 Магнум (Скоростная перезарядка). Револьвер магнум .44 с ускоренным заряжанием.
X45Caliber: .45 Калибр. Аммуниция: .45 Калибр.
X47mmCaseless: 4.7 мм безотказные. Аммуниция. Калибр: 4.7 миллиметров безотказные.
X5mmAP: 5мм БП. Магазин с легкими боеприпасами. 5мм бронебойные.
X5mmJHP: 5мм ПСЦТ. Легкие боеприпасы. Калибр: 5мм, со смещенным центром тяжести.
X762mm: 7.62 мм. Патроны. Калибр: 7.62.
X9mm: 9 мм. Аммуниция. Калибр: 9 миллиметров.
X9mmBall: 9ти мм пули. Коллекция древних 9х19 мм патронов. Обильно смазаны для предохранения от ржавения. Обычные пули.
X9mmMauser: 9мм Маузер. Маузер м/96. В прекрасном состоянии. Очень точен.
XL70E3: XЛ70Е3. Это экспериментальное оружие времен войны. Его нельзя разрушить, ибо произведено он из прочнейших полимеров. Стреляет быстро и точно, а разобрать его можно и без инструментов.
XanderRoot: Корень Ксандер. Редкий корешок, придающий лечебные свойства целебному порошку. 
YK32PulsePistol: Импульсный пистолет ЮК32. ЮК32 - элекрическое импульсное оружие, созданное Ума Флэтс Энерджи Консорциум. Xотя он и немеренно мощный, но в серьез не использовался из-за чрезмерного потребления энергии.
YK42BPulseRifle: Импульсная винтовка ЮК42Б. ЮК41Б - электрическое импульсное оружие, созданное Ума Флэтс Энерджи Консорциум. Но этот образчик считается отпадным, ибо, по сравнению с ЮК32, у него большая емкость батарей и дальность.
YellowMemoryModule: Желтый Модуль Памяти. Модуль памяти только для чтения, содержащий медицинскую информацию. Он детализирует увеличение ума.
YellowPassKey: Ключ Желтого Допуска. Электронный ключ доступа, код -  желтый цвет.
YellowReactorKeycard: Желтая Ключ-карта Реактора. Электронный ключ доступа, код -  желтый цвет.
ZipGun: Зип пушка. Рукодельно-самопальный разово стреляющий пистолет.
